18 18
##################
#                #
#                #
#                #
#                #
#                # 
#                # 
#                #
#                #
#                #
#   #####        #
#   #   #        #
#   #####        # 
#                #
#                # 
#                #
#                #
##################