18 18
##################
#                #
#     ##     #   #
#  l  #o     #   #
#     ##     #   #
#                # 
#     o######    # 
#      #         #
#      #   ##    #
#           #    #
#   #####        #
#   #            #
#   #####   o    # 
#                #
#      # #       # 
#  l   #### i    #
#                #
##################