18 18
##################
#                #
#    ##      #   #
#    #     x #   #
#    ##      #   #
#                # 
#      ######    # 
# x    #         #
#      #   ##    #
#           #    #
#   #####        #
#   #            #
#   #####     l  # 
#             o  #
#      #x#    o  # 
#      #### i o  #
#                #
##################