6 7
#####
i #  l
# # #
# # #
# # #
#   #
#c#c# 