18 18
##################
#                #
#    ##      #   #
#    #o    x #   #
#    ##      #   #
#                # 
#      ######    # 
# xo   #o        #
#      #   ##    #
#           #    #
#   #####        #
#   #o           #
#   #####        # 
#                #
#      #x#       # 
#     ####       #
#               o#
##################