11 11
###########
#         #
#         #
#         #
#         #
#    i    #
#         #
#         #
#         #
#         #
###########