18 18
##################
#                #
# l  ##      #   #
#    #o      #   #
#    ##      #   #
#                # 
# o    ######    # 
#      #         #
#      #   ##    #
#           #    #
#   #####        #
#   #            #
#   #####        # 
#                #
#      # #       # 
#      #### i    #
#                #
##################