8 7
########
i   l  #
#   #  #
# #o   #
#   #  #
#      #
#c#c#### 